WWWWWWWWWWWWWWW
WFWFFSFWFWFFWWW
WFFFWWFFFWFWWWW
WFWFWFFFFWFWWWW
WFWWWWFWFWFFFFW
WFWWWFFFFFFWWWW
WFWWWWWWFWFFFFK
WFWFFFFFFWFWWWW
WFWFWWWWWWFWWWW
WFFFFFFFFWFWWWW
WWWWWWWWWWFWWWW
WWWWFFFFFFFWWWW
WWFFFWWWWWWWWWW
WWFWWWWWWWWWWWW
WWWWWWWWWWWWWWW