WWWWWWWWWWWWWWW
WFWFFSFFFWFFWWW
WFFFWWFWFWFWWWW
WFWFWFFWFWFWWWW
WFWWWWFWFWFFFFW
WFWWFFFWFFFWWWW
WFWWWWWWFWFFFFK
WFWFFFFFFWFWWWW
WFWFWWWWWWFWWWW
WFFFFFFFFWFWWWW
WWWWWWWWWWFWWWW
WWWWFFFFFFFWWWW
WWFFFWWWWWWWWWW
WWFWWWWWWWWWWWW
WWWWWWWWWWWWWWW